A x x x x
O x x x x
O O O O x
x x x O x
x x x O T