A O O O O O O O O O
x x x O x x x x x x
O O O O O O O O O O
O x x x x x x x x x
O O O O O O O O O x
x x x x O x x x O x
x x x x O x x O O x 
x x x x O O O O x x
x x x x O x x x x x
x x x x O O O O O T